"filename", "language", "Java", "JSON", "comment", "blank", "total"
"d:\Projects I Work On\GAME\gamer\fighter\src\main\java\com\hasan\multiplayer\projects\flighter\App.java", "Java", 31, 0, 6, 13, 50
"d:\Projects I Work On\GAME\gamer\fighter\src\main\java\com\hasan\multiplayer\projects\flighter\game\gameObjects\entities\objectType\objects\rps\enums.java", "Java", 21, 0, 0, 4, 25
"d:\Projects I Work On\GAME\gamer\fighter\src\main\java\com\hasan\multiplayer\projects\flighter\game\gameObjects\entities\objectType\objects\rps\rps.java", "Java", 4, 0, 2, 0, 6
"d:\Projects I Work On\GAME\gamer\fighter\src\main\java\com\hasan\multiplayer\projects\flighter\game\gameObjects\entities\objectType\objects\rps\rpsBackWorks.java", "Java", 124, 0, 11, -3, 132
"d:\Projects I Work On\GAME\gamer\fighter\src\main\java\com\hasan\multiplayer\projects\flighter\game\gameObjects\entities\objectType\objects\rps\rpsGameLobby.java", "Java", 1, 0, 1, 0, 2
"d:\Projects I Work On\GAME\gamer\fighter\src\main\java\com\hasan\multiplayer\projects\flighter\game\gameObjects\entities\playerType\playerTypeEntities\player.java", "Java", 2, 0, 0, 0, 2
"d:\Projects I Work On\GAME\gamer\fighter\src\main\java\com\hasan\multiplayer\projects\flighter\game\gamePanel\gamePanel.java", "Java", 12, 0, 0, 0, 12
"d:\Projects I Work On\GAME\gamer\fighter\src\main\java\com\hasan\multiplayer\projects\flighter\game\inputHandleing\mouseMotionHandler.java", "Java", 0, 0, 0, -1, -1
"d:\Projects I Work On\GAME\gamer\fighter\src\main\java\com\hasan\multiplayer\projects\flighter\game\multiplayer\personalLobby\miniGameLobby.java", "Java", 10, 0, 0, 1, 11
"d:\Projects I Work On\GAME\gamer\fighter\src\main\java\com\hasan\multiplayer\projects\flighter\game\tools\tools.java", "Java", 20, 0, 29, 3, 52
"d:\Projects I Work On\GAME\gamer\fighter\src\main\java\com\hasan\multiplayer\projects\flighter\resources\gameResources\storage.json", "JSON", 0, 33, 0, 0, 33
"Total", "-", 225, 33, 49, 17, 324