"filename", "language", "Java", "JSON", "comment", "blank", "total"
"d:\Projects I Work On\GAME\gamer\fighter\src\main\java\com\hasan\multiplayer\projects\flighter\App.java", "Java", 31, 0, 6, 13, 50
"d:\Projects I Work On\GAME\gamer\fighter\src\main\java\com\hasan\multiplayer\projects\flighter\game\HUD\HUD.java", "Java", 100, 0, 95, 15, 210
"d:\Projects I Work On\GAME\gamer\fighter\src\main\java\com\hasan\multiplayer\projects\flighter\game\HUD\entityInfoDisplay.java", "Java", 36, 0, 1, 10, 47
"d:\Projects I Work On\GAME\gamer\fighter\src\main\java\com\hasan\multiplayer\projects\flighter\game\HUD\notifyBar.java", "Java", 167, 0, 24, 18, 209
"d:\Projects I Work On\GAME\gamer\fighter\src\main\java\com\hasan\multiplayer\projects\flighter\game\HUD\notifyEnum.java", "Java", 14, 0, 0, 2, 16
"d:\Projects I Work On\GAME\gamer\fighter\src\main\java\com\hasan\multiplayer\projects\flighter\game\enums\logger.java", "Java", 145, 0, 28, 26, 199
"d:\Projects I Work On\GAME\gamer\fighter\src\main\java\com\hasan\multiplayer\projects\flighter\game\enums\multiplayer.java", "Java", 9, 0, 0, 2, 11
"d:\Projects I Work On\GAME\gamer\fighter\src\main\java\com\hasan\multiplayer\projects\flighter\game\enums\objectEnum.java", "Java", 50, 0, 0, 8, 58
"d:\Projects I Work On\GAME\gamer\fighter\src\main\java\com\hasan\multiplayer\projects\flighter\game\enums\playerEnums.java", "Java", 17, 0, 0, 2, 19
"d:\Projects I Work On\GAME\gamer\fighter\src\main\java\com\hasan\multiplayer\projects\flighter\game\enums\sources.java", "Java", 33, 0, 2, 5, 40
"d:\Projects I Work On\GAME\gamer\fighter\src\main\java\com\hasan\multiplayer\projects\flighter\game\enums\stageEnums.java", "Java", 8, 0, 0, 2, 10
"d:\Projects I Work On\GAME\gamer\fighter\src\main\java\com\hasan\multiplayer\projects\flighter\game\gameEvent\enums.java", "Java", 11, 0, 0, 3, 14
"d:\Projects I Work On\GAME\gamer\fighter\src\main\java\com\hasan\multiplayer\projects\flighter\game\gameEvent\gameEvent.java", "Java", 50, 0, 18, 7, 75
"d:\Projects I Work On\GAME\gamer\fighter\src\main\java\com\hasan\multiplayer\projects\flighter\game\gameEvent\handlers\difference.java", "Java", 30, 0, 0, 8, 38
"d:\Projects I Work On\GAME\gamer\fighter\src\main\java\com\hasan\multiplayer\projects\flighter\game\gameEvent\handlers\fuelHandler.java", "Java", 3, 0, 0, 3, 6
"d:\Projects I Work On\GAME\gamer\fighter\src\main\java\com\hasan\multiplayer\projects\flighter\game\gameEvent\handlers\handlerSkeleton.java", "Java", 26, 0, 3, 5, 34
"d:\Projects I Work On\GAME\gamer\fighter\src\main\java\com\hasan\multiplayer\projects\flighter\game\gameEvent\handlers\healthHandler.java", "Java", 33, 0, 2, 6, 41
"d:\Projects I Work On\GAME\gamer\fighter\src\main\java\com\hasan\multiplayer\projects\flighter\game\gameEvent\handlers\speedHandler.java", "Java", 3, 0, 0, 3, 6
"d:\Projects I Work On\GAME\gamer\fighter\src\main\java\com\hasan\multiplayer\projects\flighter\game\gameObjects\entities\objectType\objects\dagger.java", "Java", 132, 0, 5, 20, 157
"d:\Projects I Work On\GAME\gamer\fighter\src\main\java\com\hasan\multiplayer\projects\flighter\game\gameObjects\entities\objectType\objects\pistol.java", "Java", 71, 0, 12, 23, 106
"d:\Projects I Work On\GAME\gamer\fighter\src\main\java\com\hasan\multiplayer\projects\flighter\game\gameObjects\entities\objectType\objects\rps\enums.java", "Java", 21, 0, 0, 4, 25
"d:\Projects I Work On\GAME\gamer\fighter\src\main\java\com\hasan\multiplayer\projects\flighter\game\gameObjects\entities\objectType\objects\rps\rps.java", "Java", 181, 0, 19, 12, 212
"d:\Projects I Work On\GAME\gamer\fighter\src\main\java\com\hasan\multiplayer\projects\flighter\game\gameObjects\entities\objectType\objects\rps\rpsBackWorks.java", "Java", 373, 0, 76, 18, 467
"d:\Projects I Work On\GAME\gamer\fighter\src\main\java\com\hasan\multiplayer\projects\flighter\game\gameObjects\entities\objectType\objects\rps\rpsGameLobby.java", "Java", 69, 0, 11, 8, 88
"d:\Projects I Work On\GAME\gamer\fighter\src\main\java\com\hasan\multiplayer\projects\flighter\game\gameObjects\entities\objectType\superObject.java", "Java", 118, 0, 20, 9, 147
"d:\Projects I Work On\GAME\gamer\fighter\src\main\java\com\hasan\multiplayer\projects\flighter\game\gameObjects\entities\playerType\playerTypeEntities\player.java", "Java", 110, 0, 10, 19, 139
"d:\Projects I Work On\GAME\gamer\fighter\src\main\java\com\hasan\multiplayer\projects\flighter\game\gameObjects\entities\playerType\playerTypeEntities\remotePlayer.java", "Java", 30, 0, 2, 12, 44
"d:\Projects I Work On\GAME\gamer\fighter\src\main\java\com\hasan\multiplayer\projects\flighter\game\gameObjects\entities\playerType\superPlayer.java", "Java", 85, 0, 15, 9, 109
"d:\Projects I Work On\GAME\gamer\fighter\src\main\java\com\hasan\multiplayer\projects\flighter\game\gameObjects\enums\gameObjectType.java", "Java", 10, 0, 0, 3, 13
"d:\Projects I Work On\GAME\gamer\fighter\src\main\java\com\hasan\multiplayer\projects\flighter\game\gameObjects\gameObject.java", "Java", 34, 0, 24, 6, 64
"d:\Projects I Work On\GAME\gamer\fighter\src\main\java\com\hasan\multiplayer\projects\flighter\game\gamePanel\gamePanel.java", "Java", 137, 0, 29, 20, 186
"d:\Projects I Work On\GAME\gamer\fighter\src\main\java\com\hasan\multiplayer\projects\flighter\game\inputHandleing\KeyHandler.java", "Java", 111, 0, 7, 10, 128
"d:\Projects I Work On\GAME\gamer\fighter\src\main\java\com\hasan\multiplayer\projects\flighter\game\inputHandleing\mouseHandler.java", "Java", 32, 0, 7, 8, 47
"d:\Projects I Work On\GAME\gamer\fighter\src\main\java\com\hasan\multiplayer\projects\flighter\game\inputHandleing\mouseMotionHandler.java", "Java", 19, 0, 7, 6, 32
"d:\Projects I Work On\GAME\gamer\fighter\src\main\java\com\hasan\multiplayer\projects\flighter\game\interfaces\gunType.java", "Java", 41, 0, 0, 4, 45
"d:\Projects I Work On\GAME\gamer\fighter\src\main\java\com\hasan\multiplayer\projects\flighter\game\interfaces\weapon.java", "Java", 5, 0, 7, 2, 14
"d:\Projects I Work On\GAME\gamer\fighter\src\main\java\com\hasan\multiplayer\projects\flighter\game\multiplayer\handlers\objectDeleteHandler.java", "Java", 53, 0, 3, 8, 64
"d:\Projects I Work On\GAME\gamer\fighter\src\main\java\com\hasan\multiplayer\projects\flighter\game\multiplayer\handlers\objectSpawnHandler.java", "Java", 76, 0, 1, 9, 86
"d:\Projects I Work On\GAME\gamer\fighter\src\main\java\com\hasan\multiplayer\projects\flighter\game\multiplayer\handlers\objectUpdateHandler.java", "Java", 33, 0, 2, 7, 42
"d:\Projects I Work On\GAME\gamer\fighter\src\main\java\com\hasan\multiplayer\projects\flighter\game\multiplayer\handlers\playerDeleteHandler.java", "Java", 42, 0, 18, 8, 68
"d:\Projects I Work On\GAME\gamer\fighter\src\main\java\com\hasan\multiplayer\projects\flighter\game\multiplayer\handlers\playerSpawnHandler.java", "Java", 41, 0, 9, 8, 58
"d:\Projects I Work On\GAME\gamer\fighter\src\main\java\com\hasan\multiplayer\projects\flighter\game\multiplayer\handlers\playerUpdateHandler.java", "Java", 38, 0, 12, 8, 58
"d:\Projects I Work On\GAME\gamer\fighter\src\main\java\com\hasan\multiplayer\projects\flighter\game\multiplayer\multiplayer.java", "Java", 197, 0, 27, 23, 247
"d:\Projects I Work On\GAME\gamer\fighter\src\main\java\com\hasan\multiplayer\projects\flighter\game\multiplayer\personalLobby\miniGameLobby.java", "Java", 80, 0, 23, 11, 114
"d:\Projects I Work On\GAME\gamer\fighter\src\main\java\com\hasan\multiplayer\projects\flighter\game\stage\stageManager.java", "Java", 99, 0, 22, 16, 137
"d:\Projects I Work On\GAME\gamer\fighter\src\main\java\com\hasan\multiplayer\projects\flighter\game\stage\tile.java", "Java", 17, 0, 14, 5, 36
"d:\Projects I Work On\GAME\gamer\fighter\src\main\java\com\hasan\multiplayer\projects\flighter\game\tools\debugMenu.java", "Java", 3, 0, 0, 3, 6
"d:\Projects I Work On\GAME\gamer\fighter\src\main\java\com\hasan\multiplayer\projects\flighter\game\tools\move.java", "Java", 23, 0, 8, 5, 36
"d:\Projects I Work On\GAME\gamer\fighter\src\main\java\com\hasan\multiplayer\projects\flighter\game\tools\tools.java", "Java", 90, 0, 56, 11, 157
"d:\Projects I Work On\GAME\gamer\fighter\src\main\java\com\hasan\multiplayer\projects\flighter\resources\gameResources\storage.json", "JSON", 0, 33, 0, 0, 33
"Total", "-", 3137, 33, 625, 453, 4248